R 640 480


C 255,130,140
NO ./textures/redbrick.xpm
SO ./textures/mossy.xpm
WE ./textures/mossy.xpm
EA ./textures/mossy.xpm
S ./textures/pillar.xpm

F 255,55,30


        1111111111111111111111111
        1000000000112222222222221
        1011000001112222222222221
        1001000000E00000022222221
111111111011000001110000002222221
110111111111110110000222221000001
1000000001 1000001110111111111111
1111011111 111011100000010001
11110111111111011101010010201  111
11000000110101011100000010201  101
10000000000000001100000000201  111
10000000000000001101010010201
1100000111010101111101111000111
11110111 1110101 101111010201
11111111 1111111 111111111111
1             1                1